423 424 421 422 423 424 421 422 423 424 255 409 410 385 386 387 388 385 386 387 388 385 386 387 388 385 386 387 388 385 386 387 388 385 386 387 388 385 386 387 388 385 386 387 388 385 386 387 388 385 386 387 388 385 386 387 388 385 386 387 388 385 386 387
429 430 427 428 429 430 427 428 429 430 8 415 416 391 392 393 394 391 392 393 394 391 392 393 394 391 392 393 394 391 392 393 394 391 392 393 394 391 392 393 394 391 392 393 394 391 392 393 394 391 392 393 394 391 392 393 394 391 392 393 394 391 392 393
8 8 8 367 8 8 8 8 8 8 8 421 422 397 398 399 400 397 398 399 400 397 398 399 400 397 398 399 400 397 398 399 400 397 398 399 400 397 398 399 400 397 398 399 400 397 398 399 400 397 398 399 400 397 398 399 400 397 398 399 400 397 398 399
8 8 8 373 8 8 487 488 489 239 8 427 428 403 404 405 406 403 404 405 406 403 404 405 406 403 404 405 406 403 404 405 406 403 404 405 406 403 404 405 406 403 404 405 406 403 404 405 406 403 404 405 406 403 404 405 406 403 404 405 406 403 404 405
8 8 8 379 8 8 493 494 495 8 8 8 8 427 428 429 430 427 428 429 430 427 428 429 430 427 428 429 430 427 428 429 430 427 428 429 430 427 428 429 430 427 428 429 430 427 428 429 430 427 428 429 430 427 428 429 430 427 428 429 430 427 428 429
409 410 411 412 8 8 499 500 501 8 8 8 8 8 8 8 8 8 8 8 8 8 8 8 8 8 8 110 8 8 8 8 8 8 370 8 8 8 8 8 8 8 8 8 8 8 373 8 8 8 487 488 489 8 8 8 110 8 8 8 8 8 262 263
385 386 387 388 411 412 505 506 507 8 193 194 194 194 195 8 8 8 8 8 110 110 8 8 8 410 411 8 8 251 8 8 8 8 376 8 8 8 8 8 8 8 8 8 8 8 379 8 8 8 493 494 495 8 8 8 8 8 241 242 8 8 268 269
391 392 393 394 417 418 511 512 513 8 199 200 200 200 201 8 367 8 8 8 8 8 409 410 385 386 387 388 411 412 8 8 8 8 382 8 8 8 8 8 8 8 8 110 8 8 8 8 8 8 499 500 501 8 8 8 8 8 247 248 8 8 8 251
397 398 399 400 423 424 517 518 519 8 205 206 206 206 207 8 373 8 8 8 187 8 415 416 391 392 393 394 417 418 8 8 8 8 8 8 8 241 242 8 8 8 410 411 8 8 8 8 8 8 505 506 507 8 8 8 8 8 8 8 433 434 435 436
403 404 405 406 429 430 523 524 525 8 8 368 369 8 8 8 379 430 430 430 430 430 421 422 397 416 417 400 423 424 430 430 430 430 430 430 430 247 248 430 410 385 386 387 388 411 412 8 8 8 511 512 513 8 239 8 8 8 8 110 439 440 441 442
427 428 429 430 8 8 409 410 411 412 8 374 375 430 430 430 430 163 164 164 164 165 430 428 403 422 423 406 429 430 163 164 164 164 164 164 164 164 165 415 416 391 392 393 394 417 418 8 8 8 517 518 519 8 8 8 8 8 8 8 445 446 447 448
8 8 8 110 8 370 415 416 417 418 8 380 381 163 164 164 164 142 170 170 170 171 430 430 430 428 429 430 430 430 169 170 170 170 170 170 170 170 171 421 422 397 416 417 400 423 424 8 8 8 523 524 525 8 8 8 8 8 8 8 451 452 453 454
8 8 8 110 110 376 421 422 423 424 139 141 430 169 146 170 170 170 170 170 170 144 164 164 164 164 164 164 164 164 142 170 170 156 152 154 170 170 171 430 428 403 422 423 406 429 430 8 8 8 8 8 8 8 8 8 409 410 411 412 8 260 261 8
433 434 435 436 8 382 427 428 429 430 151 153 430 169 170 170 156 152 152 152 154 170 170 170 170 170 170 170 170 170 170 170 170 147 367 145 146 146 171 430 8 427 428 429 430 430 430 430 430 430 430 8 110 110 8 8 415 416 417 418 8 266 267 8
439 440 441 442 8 8 8 8 8 8 430 273 274 175 154 170 147 8 8 8 145 170 170 170 170 170 170 170 170 170 170 170 170 147 373 145 170 170 171 430 8 8 430 368 369 163 164 164 164 165 430 8 8 8 8 8 421 422 423 424 8 8 8 253
445 446 447 448 8 8 410 411 8 8 430 279 280 8 145 170 144 141 8 8 145 170 170 170 170 170 170 170 170 170 170 170 170 147 379 145 170 170 171 430 256 8 8 374 375 175 154 146 170 171 430 8 8 410 411 8 427 428 429 430 8 8 265 8
451 452 453 454 410 385 386 387 388 411 430 139 140 141 145 170 170 144 140 140 142 170 170 170 170 170 170 170 170 170 170 170 170 144 140 142 170 170 171 430 430 430 430 380 381 430 169 146 156 177 430 410 385 386 387 388 411 412 8 8 8 8 260 261
367 8 8 415 416 391 392 393 394 417 418 145 170 147 145 170 170 170 170 170 170 170 170 170 170 170 170 170 170 170 170 156 152 152 154 146 170 170 144 164 164 164 164 164 164 165 169 170 147 430 415 416 391 392 393 394 417 418 8 8 8 8 266 267
373 8 8 421 422 397 416 417 400 423 424 145 170 147 145 170 170 170 170 170 170 170 170 170 170 170 170 170 170 170 170 147 241 242 145 170 170 170 170 170 170 170 170 170 170 144 142 170 144 165 421 422 397 416 417 400 423 424 8 8 409 410 411 412
379 8 8 427 428 403 422 423 406 429 430 145 170 144 142 170 170 170 170 170 170 170 170 170 170 170 170 170 170 170 170 147 247 248 151 154 170 146 146 170 170 170 170 170 170 170 170 170 170 147 430 428 403 422 423 406 429 430 8 8 415 416 417 418
8 271 272 8 8 427 428 429 430 430 430 145 170 170 170 170 146 156 152 154 170 170 170 170 170 170 170 170 170 170 170 147 8 8 8 148 170 170 170 170 170 170 170 170 170 170 170 170 170 147 368 369 430 428 429 430 8 8 409 410 457 458 459 460
8 277 278 8 8 410 411 8 8 430 139 142 170 170 170 170 146 147 8 145 170 170 170 170 170 170 170 170 170 170 170 144 140 140 140 142 170 170 170 170 170 170 170 170 170 170 170 170 170 147 374 375 430 8 8 8 8 8 415 416 463 464 465 466
411 412 409 410 385 386 387 388 411 430 145 170 170 170 170 170 170 147 253 145 170 170 170 170 170 170 170 170 170 170 170 170 170 170 170 170 170 180 176 176 178 170 170 146 170 170 170 170 170 147 380 381 430 8 8 8 8 8 421 422 469 470 471 472
417 418 415 416 391 392 393 394 417 418 145 170 156 154 170 170 170 147 8 145 170 170 170 156 152 152 152 152 154 170 170 170 170 170 170 146 180 177 8 8 175 176 176 178 170 170 170 170 170 147 430 430 430 110 367 8 8 8 427 428 475 476 477 478
423 424 421 422 397 416 417 400 423 424 145 170 144 142 170 170 170 144 140 142 156 155 152 153 410 411 8 8 145 170 170 170 156 154 170 170 171 8 8 255 8 8 8 169 146 146 146 146 170 147 430 8 8 8 373 8 8 8 110 110 421 422 423 424
429 430 427 428 403 422 423 406 429 430 145 170 170 170 170 170 170 170 170 170 147 409 410 385 386 387 388 411 151 154 170 170 144 142 170 170 168 164 165 8 193 195 8 169 146 146 146 146 170 147 430 8 8 8 379 8 8 8 8 8 427 428 429 430
411 412 8 8 427 428 429 430 367 430 145 170 170 170 170 170 170 170 170 170 147 415 416 391 392 393 394 417 418 145 170 170 170 170 170 170 170 146 171 8 205 207 8 169 146 146 156 154 170 147 430 8 8 8 8 8 8 8 8 8 8 8 241 242
417 418 187 8 8 8 8 8 373 430 145 170 170 170 170 170 170 170 170 170 147 421 422 397 416 417 400 423 424 145 170 170 170 170 170 170 170 146 168 165 8 163 164 166 146 146 147 175 176 153 430 239 8 8 8 433 434 435 436 8 8 8 247 248
423 424 8 433 434 435 436 8 379 430 145 170 170 170 170 170 170 170 170 170 147 427 428 403 422 423 406 429 139 142 170 170 170 170 170 170 170 146 146 168 164 166 146 146 146 156 153 430 430 430 430 8 8 8 8 439 440 441 442 8 273 274 8 8
429 430 8 439 440 441 442 8 8 430 151 152 152 152 152 152 152 152 154 170 147 8 8 427 428 429 430 139 142 170 170 170 170 170 170 170 170 146 146 146 146 146 146 146 156 153 430 8 410 411 8 8 8 8 8 445 446 447 448 8 279 280 8 8
8 239 8 445 446 447 448 8 8 410 411 430 430 187 8 8 8 8 145 170 144 140 140 140 140 140 140 142 170 170 170 170 170 170 170 170 170 170 170 170 170 170 170 170 147 430 410 385 386 387 388 411 412 8 8 451 452 453 454 110 253 8 8 8
409 410 411 451 452 453 454 410 385 386 387 388 411 430 139 140 140 140 142 170 170 170 170 170 170 170 170 170 156 152 152 154 170 170 170 170 170 170 170 170 170 170 170 170 147 415 416 391 392 393 394 417 418 8 8 8 409 410 411 412 409 410 411 412
385 386 387 388 411 412 415 416 391 392 393 394 417 418 145 170 170 170 170 170 170 170 170 170 170 170 170 170 147 265 8 145 170 170 170 170 170 170 170 170 170 170 170 170 150 421 422 397 416 417 400 423 424 8 409 410 385 386 387 388 385 386 387 388
391 392 393 394 417 418 421 422 397 416 417 400 423 424 148 170 170 170 170 170 170 170 170 170 170 170 170 170 147 8 8 145 170 170 170 170 170 170 170 170 156 154 170 170 147 430 428 403 422 423 406 429 430 8 415 416 391 392 393 394 391 392 393 394
397 398 399 400 423 424 427 428 403 422 423 406 429 430 145 170 170 170 170 156 152 152 152 152 154 170 170 170 150 8 8 145 170 170 170 170 170 170 170 170 144 142 170 170 147 430 430 430 428 429 430 8 368 369 421 422 397 398 399 400 397 398 399 400
403 404 405 406 429 430 8 8 427 428 429 430 8 430 145 170 170 170 170 147 8 8 8 8 145 170 170 170 147 8 8 145 170 170 170 170 170 170 170 170 170 170 170 170 144 164 164 164 164 165 430 8 374 375 427 428 403 404 405 406 403 404 405 406
427 428 429 430 8 8 8 187 8 430 430 430 430 430 145 170 170 170 170 147 8 110 8 8 145 170 170 170 144 140 140 142 170 170 170 170 170 170 170 170 170 170 170 170 170 170 170 170 170 171 430 8 380 381 8 8 427 428 429 430 427 428 429 430
8 110 110 265 8 8 8 368 369 430 139 140 140 140 142 170 170 170 170 147 8 8 8 8 145 170 170 170 170 170 170 170 170 170 170 170 170 170 170 156 152 155 152 154 170 170 170 170 170 171 430 8 8 8 8 8 8 493 494 495 8 8 409 410
409 410 411 412 8 8 8 374 375 430 145 170 170 170 170 170 170 170 170 144 140 140 143 140 142 170 170 170 170 170 170 170 170 170 170 170 170 170 170 147 271 272 8 145 170 170 170 170 170 171 430 253 8 8 8 8 8 499 500 501 8 8 415 416
385 386 387 388 411 412 8 380 381 430 145 170 170 170 170 170 170 170 170 170 170 170 170 170 170 170 170 156 154 170 170 170 170 170 170 170 170 170 170 147 277 278 8 151 152 152 154 170 170 171 370 430 8 8 8 8 8 505 506 507 8 8 421 422
391 392 393 394 417 418 8 8 8 430 145 170 170 170 170 170 170 170 170 170 170 170 170 170 170 170 170 144 142 170 170 170 170 170 170 170 156 152 152 153 8 8 187 8 8 8 169 146 170 171 376 430 8 8 8 8 8 511 512 513 8 8 427 428
397 398 399 400 423 424 271 272 8 430 145 170 170 170 170 170 170 170 170 170 170 170 170 170 170 170 170 170 170 170 170 170 170 170 170 170 147 193 195 8 139 141 8 8 8 8 169 146 156 177 382 430 8 8 8 8 8 517 518 519 8 8 8 8
403 404 405 406 429 430 277 278 8 430 151 152 152 154 170 170 156 152 152 152 152 152 152 152 152 154 170 170 170 170 170 170 170 170 170 170 147 199 201 8 145 144 140 140 141 8 169 146 147 430 430 430 410 411 8 8 8 523 524 525 8 8 8 8
427 428 429 430 8 8 8 8 410 411 430 430 430 145 170 170 147 8 193 194 194 194 194 195 8 145 170 170 170 170 170 170 170 170 170 170 147 205 207 8 151 154 146 146 147 8 169 146 147 430 410 385 386 387 388 411 412 8 8 8 433 434 435 436
409 410 411 412 8 409 410 385 386 387 388 411 430 145 170 170 147 8 205 206 206 206 206 207 8 148 170 170 170 170 170 170 170 170 170 170 147 8 8 8 8 145 146 146 147 8 169 146 147 415 416 391 392 393 394 417 418 8 8 8 439 440 441 442
385 386 387 388 411 415 416 391 392 393 394 417 418 148 170 170 144 140 140 140 140 140 140 140 140 142 156 154 170 170 170 170 170 170 170 170 144 140 140 140 140 142 146 146 144 140 142 146 147 421 422 397 416 417 400 423 424 8 8 8 445 446 447 448
391 392 393 394 417 421 422 397 416 417 400 423 424 145 170 170 170 170 170 170 170 170 170 170 170 170 144 142 170 170 170 170 170 170 170 170 170 170 170 146 146 146 146 146 146 170 170 170 147 430 428 403 422 423 406 429 430 8 8 8 451 452 453 454
397 398 399 400 423 424 428 403 422 423 406 429 430 145 170 170 170 170 170 170 170 170 170 170 170 170 170 170 170 170 170 170 170 170 170 170 170 170 170 146 146 170 170 170 170 170 170 170 147 430 8 427 428 429 430 8 8 8 8 237 238 8 409 410
403 404 405 406 429 8 8 427 428 429 430 8 430 145 170 170 170 156 152 152 152 152 152 152 152 152 152 152 152 152 152 152 152 152 152 152 152 152 152 155 152 152 152 152 154 170 170 170 144 165 430 8 8 8 8 8 8 110 110 243 244 8 415 416
427 428 429 430 8 110 8 8 8 430 139 140 140 142 156 152 152 177 410 411 430 430 430 368 369 430 430 430 430 430 430 229 430 430 260 261 430 430 430 430 430 430 430 430 175 176 176 176 176 177 430 8 8 8 8 8 8 8 110 249 250 8 421 422
409 410 411 412 409 410 411 412 8 430 151 152 152 152 153 430 410 385 386 387 388 411 412 374 375 8 8 8 8 8 8 8 370 8 266 267 8 409 410 411 412 8 8 8 430 410 411 430 430 430 368 369 430 8 8 8 8 8 8 8 8 229 427 428
385 386 387 388 385 386 387 388 411 430 367 430 430 430 430 415 416 391 392 393 394 417 418 380 381 8 8 8 8 8 8 8 376 8 8 8 8 415 416 417 418 8 409 410 385 386 387 388 411 412 374 375 430 8 409 410 411 412 409 410 411 412 409 410
391 392 393 394 391 392 393 394 417 418 373 8 487 488 489 421 422 397 416 417 400 423 424 8 224 225 8 8 8 368 369 110 382 8 8 8 8 421 422 423 424 8 415 416 391 392 393 394 417 418 380 381 430 410 385 386 387 388 385 386 387 388 385 386
397 398 399 400 397 398 399 400 423 424 379 8 493 494 495 427 428 403 422 423 406 429 430 8 230 231 8 8 8 374 375 8 8 8 8 8 8 427 428 429 430 8 421 422 397 416 417 400 423 424 430 430 415 416 391 392 393 394 391 392 393 394 391 392
403 404 405 406 403 404 405 406 429 430 8 8 499 500 501 8 8 427 428 429 430 8 8 8 8 8 8 187 8 380 381 8 8 8 8 8 8 8 8 8 8 8 427 428 403 422 423 406 429 430 8 8 421 422 397 398 399 400 397 398 399 400 397 398
427 428 429 430 427 428 429 430 8 8 8 8 505 506 507 8 8 8 8 8 8 410 411 412 8 410 411 412 8 410 411 412 8 410 411 412 8 410 411 412 8 410 411 412 427 428 429 430 8 8 8 8 427 428 403 404 405 406 403 404 405 406 403 404
8 254 8 8 8 8 8 367 8 8 8 239 511 512 513 8 8 8 409 410 385 386 387 388 385 386 387 388 385 386 387 388 385 386 387 388 385 386 387 388 385 386 387 388 411 412 8 8 8 239 8 8 367 8 427 428 429 430 427 428 429 430 427 428
370 8 273 274 8 8 8 373 8 8 8 8 517 518 519 8 8 8 415 416 391 392 393 394 391 392 393 394 391 392 393 394 391 392 393 394 391 392 393 394 391 392 393 394 417 418 8 8 8 8 8 8 373 8 8 8 8 217 8 8 8 8 226 227
376 8 279 280 8 8 8 379 409 8 8 412 523 524 525 8 8 8 421 422 397 398 399 400 397 398 399 400 397 398 399 400 397 398 399 400 397 398 399 400 397 398 399 400 423 424 8 8 8 8 8 8 379 8 8 8 8 8 8 409 410 411 232 233
382 410 411 412 409 410 411 412 409 410 411 412 409 410 411 412 8 8 427 428 403 404 405 406 403 404 405 406 403 404 405 406 403 404 405 406 403 404 405 406 403 404 405 406 429 430 8 8 8 409 410 411 412 8 8 8 8 8 8 415 416 417 418 415
385 386 387 388 385 386 387 388 385 386 387 388 385 386 387 388 411 412 8 8 8 428 429 430 8 428 429 430 367 428 429 430 427 428 429 430 427 428 429 430 427 428 429 430 8 8 8 8 8 415 416 417 418 8 8 8 8 8 8 421 422 423 424 421
391 392 393 394 391 392 393 394 391 392 393 394 391 392 393 394 417 418 8 8 8 8 8 8 8 110 110 8 373 8 8 8 8 241 242 8 8 8 8 8 8 8 8 8 8 8 265 8 8 421 422 423 424 8 8 8 8 8 8 427 428 429 430 427
397 398 399 400 397 398 399 400 397 398 399 400 397 398 399 400 423 424 8 271 272 8 8 8 8 110 8 8 379 8 8 8 8 247 248 8 8 8 8 8 8 8 8 8 8 8 8 8 110 427 428 429 430 253 370 271 272 8 8 8 8 409 410 411
403 404 405 406 403 404 405 406 403 404 405 406 403 404 405 406 429 430 8 277 278 8 409 410 411 412 409 410 411 412 409 410 411 412 409 410 411 412 409 410 411 412 409 410 411 412 409 410 411 412 409 410 411 412 376 277 278 409 410 411 239 415 416 417