385 386 387 388 385 386 387 388 385 386 387 388 385 386 387 388 385 386 387 388 385 386 387 388 385 386 387 388 385 386 387 388 385 386 387 388 385 386 387 388 385 386 387 388 385 386 387 388 385 386 387 388 385 386 387 388 385 386 387 388 385 386 387 388
391 392 393 394 391 392 393 394 391 392 393 394 391 392 393 394 391 392 393 394 391 392 393 394 391 392 393 394 391 392 393 394 391 392 393 394 391 392 393 394 391 392 393 394 391 392 393 394 391 392 393 394 391 392 393 394 391 392 393 394 391 392 393 394
397 398 399 400 397 398 399 400 397 398 399 400 397 398 399 400 397 398 399 400 397 398 399 400 397 398 399 400 397 398 399 400 397 398 399 400 397 398 399 400 397 398 399 400 397 398 399 400 397 398 399 400 397 398 399 400 397 398 399 400 397 398 399 400
403 404 405 406 403 404 405 406 403 404 405 406 403 404 405 406 403 404 405 406 403 404 405 406 403 404 405 406 403 404 405 406 403 404 405 406 403 404 405 406 403 404 405 406 403 404 405 406 403 404 405 406 403 404 405 406 403 404 405 406 403 404 405 406
427 428 429 430 427 428 429 430 427 428 429 430 427 428 429 430 427 428 429 430 427 428 429 430 427 428 429 430 427 428 429 430 427 428 429 430 427 428 429 430 427 428 429 430 427 428 429 112 427 428 429 430 427 428 429 430 427 428 429 430 427 428 429 430
8 8 239 8 8 8 8 8 8 8 8 8 8 8 8 8 8 8 8 8 8 8 8 8 8 8 125 8 8 8 8 8 8 8 8 8 8 8 8 8 8 8 8 8 8 8 112 112 112 112 112 112 8 8 8 667 668 669 670 671 8 8 8 8
411 251 409 410 411 412 8 8 8 110 8 8 8 8 8 8 8 8 8 8 8 8 8 8 8 8 8 8 8 8 8 8 8 8 8 8 8 8 8 368 369 8 8 119 8 8 8 8 112 112 8 8 8 8 8 673 674 675 676 677 8 8 8 8
387 388 385 386 387 388 411 412 8 110 110 8 8 409 410 411 412 409 410 411 412 8 8 8 8 8 8 8 8 114 8 8 8 8 8 8 8 8 8 374 375 8 8 8 8 8 8 8 8 8 260 261 8 8 8 679 680 681 682 683 8 8 8 8
393 394 391 392 393 394 417 418 8 110 110 8 8 415 416 417 418 415 416 417 418 8 8 260 261 8 8 8 8 8 8 8 8 8 8 8 8 8 8 380 381 8 8 8 8 8 8 8 8 8 266 267 8 8 8 685 686 687 688 689 260 261 409 410
399 400 397 398 399 400 423 424 110 110 8 409 410 457 458 459 460 457 458 459 460 411 412 266 267 8 8 559 560 561 562 613 614 615 616 617 8 8 8 8 8 125 8 8 8 8 8 8 8 110 110 8 8 114 8 691 692 693 694 695 266 267 415 416
405 406 403 404 405 406 429 430 8 8 8 415 416 463 464 465 466 463 464 465 466 417 418 8 8 8 8 565 566 567 568 619 620 621 622 623 8 8 8 8 8 409 410 411 412 409 410 411 412 8 8 8 8 8 8 697 698 699 700 701 409 410 457 458
429 430 427 428 429 430 8 8 368 369 8 421 422 469 470 471 472 469 470 471 472 423 424 8 8 8 8 571 572 573 574 625 626 627 628 629 8 112 8 8 8 415 416 417 418 415 416 417 418 8 8 8 367 8 8 703 704 705 706 707 415 416 463 464
495 241 242 8 8 8 8 8 374 375 8 427 428 475 476 477 478 475 476 477 478 429 430 8 8 8 8 577 578 579 580 631 632 633 634 635 8 8 8 409 410 457 458 459 460 457 458 459 460 411 412 8 373 8 8 709 710 711 712 713 421 422 469 470
501 247 248 8 8 8 8 8 380 381 8 8 8 481 482 483 484 481 482 483 484 8 8 8 8 8 8 583 584 585 586 637 638 639 640 641 8 8 8 415 416 463 464 465 466 463 464 465 466 417 418 8 379 8 8 8 8 8 8 8 427 428 475 476
507 8 8 8 8 8 8 8 8 8 8 8 8 427 428 429 430 427 428 429 430 8 8 8 8 8 8 589 590 591 698 699 700 645 646 647 8 8 8 421 422 469 470 471 472 469 470 471 472 423 424 8 8 8 8 126 163 164 165 8 409 410 457 458
513 8 8 409 410 411 412 110 8 8 8 112 8 8 8 8 125 8 8 8 8 110 110 8 8 8 8 595 596 597 704 705 706 651 652 653 110 8 8 427 428 475 476 477 478 475 476 477 478 429 430 8 8 8 163 164 166 146 171 8 415 416 463 464
260 261 8 415 416 417 418 110 110 110 8 8 8 8 8 8 8 8 8 8 110 110 8 8 8 126 8 601 602 603 710 711 712 657 658 659 110 110 8 8 8 481 482 483 484 481 482 483 484 8 8 8 8 163 166 146 146 180 177 8 421 422 469 470
266 267 8 421 422 423 424 8 110 8 8 667 668 669 670 671 8 8 8 110 110 8 8 8 8 8 8 8 8 8 163 164 165 8 8 114 8 110 110 8 125 427 428 429 8 427 428 429 8 8 8 8 163 166 146 146 180 177 8 112 427 428 475 476
410 411 412 427 428 429 430 8 8 8 8 673 674 675 676 677 8 8 8 8 367 8 8 409 410 411 412 8 8 8 169 170 171 8 8 8 8 110 8 8 283 284 284 284 284 284 285 286 8 8 8 163 166 146 180 176 177 8 8 8 409 410 457 458
386 387 388 411 412 8 8 8 8 8 8 679 680 681 682 683 8 110 110 8 373 8 8 415 416 417 418 8 8 8 169 146 168 165 8 8 8 8 8 8 8 8 8 8 8 8 8 8 8 8 163 166 146 180 177 433 434 435 436 8 415 416 463 464
392 393 394 417 418 8 8 8 8 8 8 685 686 687 688 689 8 8 110 8 379 8 8 421 422 423 424 8 8 8 175 178 146 171 8 8 163 164 164 164 164 165 8 8 8 163 164 164 164 164 166 146 180 177 8 439 440 441 442 8 421 422 469 470
398 399 400 423 424 8 8 8 8 8 8 691 692 693 694 695 8 8 110 8 8 8 8 427 428 429 430 8 8 163 164 166 146 168 164 164 166 146 146 146 146 168 164 164 164 166 146 146 146 146 146 180 177 110 8 445 446 447 448 8 427 428 475 476
404 405 406 429 430 8 8 260 261 8 8 697 698 699 700 701 8 8 8 8 8 8 124 8 8 163 164 164 164 166 146 146 146 146 146 146 146 180 176 178 146 146 146 146 146 146 146 180 176 176 176 177 110 110 8 451 452 453 454 8 8 8 481 482
428 429 237 238 8 8 8 266 267 8 8 703 704 705 706 707 8 126 8 8 8 8 8 163 164 166 146 146 146 146 146 180 176 176 176 176 176 177 8 175 176 176 176 176 176 176 176 177 8 367 8 8 8 8 8 8 8 8 8 8 8 8 427 428
411 412 243 244 8 8 8 8 8 8 8 709 710 711 712 713 8 8 8 8 163 164 164 166 146 146 146 180 176 176 176 177 8 8 8 163 164 165 8 8 8 8 409 410 411 412 8 8 8 373 8 8 8 8 8 8 22 32 32 32 32 32 32 32
417 418 249 250 8 200 200 200 200 8 8 8 8 8 8 8 8 8 163 164 166 146 146 146 146 180 176 177 193 195 8 8 8 8 8 169 146 168 164 165 409 410 385 386 387 388 411 412 8 379 8 8 8 22 32 32 33 8 8 8 8 8 433 434
423 424 8 8 254 8 200 200 200 200 200 8 163 164 164 164 164 164 166 146 146 146 180 176 176 177 8 193 200 207 8 110 110 8 8 175 178 146 146 171 415 416 391 392 393 394 417 418 8 8 8 8 22 33 8 194 194 194 200 200 200 8 439 440
429 430 8 8 8 8 200 200 200 200 200 8 169 146 146 146 146 146 146 146 180 176 177 8 8 8 193 200 201 8 110 110 8 8 8 8 175 176 176 177 421 422 397 398 399 400 423 424 8 8 8 22 33 8 200 200 200 200 200 200 200 200 445 446
32 32 32 32 32 24 8 8 8 8 200 8 175 176 176 176 176 176 176 176 177 8 8 8 8 8 199 200 201 8 110 110 110 8 8 8 8 8 8 110 427 428 403 404 405 406 429 430 8 8 22 33 8 8 200 200 200 200 200 8 8 8 451 452
8 8 368 369 8 31 32 32 32 32 24 8 8 8 8 8 8 8 8 8 8 8 8 8 8 8 199 200 201 8 110 110 110 163 165 8 8 110 110 110 8 8 427 428 429 430 8 8 8 22 33 8 8 200 200 200 8 409 410 411 412 8 241 242
411 412 374 375 8 8 8 8 8 8 31 32 32 32 24 8 8 8 8 8 8 8 8 8 8 119 205 200 201 110 110 8 8 175 177 8 110 110 110 110 8 125 8 8 8 8 8 22 32 33 8 8 200 200 200 200 200 415 416 417 418 8 247 248
417 418 380 381 8 8 8 409 410 411 412 8 8 8 31 32 32 32 32 32 32 24 8 8 8 8 8 205 207 8 114 8 8 8 8 8 8 8 110 110 110 8 8 8 8 22 32 33 8 8 8 200 200 200 8 8 8 421 422 423 424 251 8 8
423 424 8 8 8 110 110 415 416 417 418 8 8 8 8 8 8 8 8 8 8 31 32 24 8 8 8 8 8 8 8 8 8 8 8 8 8 8 8 110 110 8 22 32 32 33 8 8 8 8 8 8 8 8 8 8 8 427 428 429 430 409 410 411
429 430 8 8 8 110 8 421 422 423 424 8 8 8 8 8 8 8 8 8 8 8 8 31 32 32 32 32 32 32 32 275 113 113 113 113 113 276 32 32 32 32 33 124 8 8 8 8 8 8 8 721 722 616 617 8 8 8 8 8 8 415 416 417
411 412 8 8 110 110 8 427 428 429 430 8 8 8 8 8 8 8 8 114 8 8 8 8 409 410 411 412 8 8 8 8 8 139 140 141 8 409 410 411 412 8 8 8 273 274 8 8 8 8 8 727 728 622 623 8 8 8 8 409 410 457 458 459
417 418 8 8 8 110 8 8 8 8 262 263 8 8 8 4 5 5 5 6 8 8 8 8 415 416 417 418 8 8 8 8 8 145 146 147 8 415 416 417 418 114 8 8 279 280 8 8 8 8 8 733 734 628 629 8 8 8 8 415 416 463 464 465
423 424 8 8 8 8 8 8 8 8 268 269 8 4 14 15 11 11 11 13 5 6 8 8 421 422 423 424 163 164 165 8 8 151 152 153 8 421 422 423 424 8 8 8 8 8 8 8 8 8 8 739 740 634 635 8 8 8 8 421 422 469 470 471
429 430 8 8 8 8 367 8 8 8 8 8 4 15 11 11 37 38 39 11 11 12 8 8 427 428 429 430 175 176 177 8 8 139 140 141 8 427 428 429 430 8 8 8 8 8 8 8 8 8 8 745 746 640 641 8 8 8 8 427 428 475 476 477
411 412 8 8 8 8 373 8 8 8 8 8 9 11 11 37 40 44 45 11 11 12 124 8 8 8 8 8 8 409 410 411 412 145 146 144 141 8 8 8 8 8 8 239 8 8 110 110 110 8 8 751 752 646 647 8 8 8 8 409 410 457 458 459
417 418 8 8 8 8 379 8 8 110 8 8 9 11 11 43 44 44 45 11 11 12 8 8 433 434 435 436 8 415 416 417 418 145 146 146 144 141 8 8 8 8 8 8 110 110 110 8 139 141 8 757 758 652 653 8 8 8 8 415 416 463 464 465
423 424 8 8 8 8 8 110 110 8 8 8 16 3 11 49 50 50 51 11 11 12 8 8 439 440 441 442 8 421 422 423 424 151 154 146 146 144 141 8 8 8 8 8 8 8 8 8 151 153 8 763 764 658 659 8 114 8 8 421 422 469 470 471
429 430 8 8 8 8 8 110 8 8 112 8 8 16 3 11 11 11 11 1 17 18 8 8 445 446 447 448 8 427 428 429 430 8 151 154 146 146 144 141 8 8 8 8 8 8 8 8 8 8 8 8 8 8 8 139 140 141 8 427 428 475 476 477
411 412 8 8 8 8 8 110 8 8 8 8 8 8 16 17 17 17 17 18 114 8 8 8 451 452 453 454 8 283 284 284 284 285 286 151 154 146 146 147 8 8 8 8 8 8 8 139 140 140 140 141 8 8 8 145 146 147 367 409 410 457 458 459
417 418 8 8 8 8 409 410 411 412 409 410 411 412 409 410 411 412 8 8 8 8 8 8 8 8 8 8 8 8 139 140 140 140 140 140 142 170 146 168 140 140 140 140 140 141 8 145 146 146 146 147 8 8 8 151 152 153 373 415 416 463 464 465
423 424 8 8 409 410 385 386 387 388 385 386 387 388 385 386 387 388 411 412 8 8 110 110 8 8 8 139 140 140 166 146 146 146 146 146 146 146 146 146 146 146 146 146 146 147 8 151 152 152 152 153 8 8 8 8 8 8 379 421 422 469 470 471
429 430 8 8 415 416 391 392 393 394 391 392 393 394 391 392 393 394 417 418 8 8 110 8 8 8 139 166 146 146 146 146 180 152 152 152 152 152 152 152 152 152 152 152 152 153 8 8 8 8 8 8 8 409 410 411 412 8 8 427 428 475 476 477
411 412 8 8 421 422 397 398 399 400 397 398 399 400 397 398 399 400 423 424 8 110 110 8 8 139 166 146 146 156 152 152 153 8 8 8 200 8 8 8 8 110 110 110 8 8 8 8 8 8 8 8 8 415 416 417 418 8 8 8 8 481 482 483
417 418 8 114 427 428 403 404 405 406 403 404 405 406 403 404 405 406 429 430 8 8 8 8 139 166 146 146 180 153 8 8 200 200 200 200 200 8 119 8 110 110 110 110 8 8 8 8 8 8 139 140 141 421 422 423 424 8 8 229 8 427 428 429
423 424 8 8 8 8 427 428 429 430 427 428 429 430 427 428 429 430 8 8 8 8 8 139 166 146 180 152 153 8 200 200 8 200 200 200 200 8 8 8 110 8 8 110 8 8 8 8 8 8 145 146 147 427 428 429 430 8 8 8 8 8 8 255
429 430 8 8 8 8 8 8 8 8 112 8 8 8 125 8 8 8 8 8 8 8 139 166 146 146 147 8 8 200 200 262 263 200 8 8 409 410 411 412 409 410 411 412 409 410 411 412 112 8 145 146 144 141 8 8 8 8 200 200 200 200 8 241
410 411 412 8 8 8 8 8 8 8 112 112 8 8 8 8 367 8 8 8 8 8 145 146 146 180 153 8 8 200 8 268 269 8 8 8 415 416 417 418 415 416 417 418 415 416 417 418 8 8 151 154 146 147 8 8 200 200 200 200 200 8 265 247
416 417 418 8 8 8 110 8 8 8 112 8 8 241 242 8 373 8 8 8 8 139 166 146 180 153 8 8 200 8 8 8 8 8 409 410 457 458 459 460 457 458 459 460 457 458 459 460 411 412 8 151 152 153 8 200 200 200 200 8 8 433 434 435
422 423 424 8 8 110 110 8 8 8 271 272 8 247 248 8 379 8 8 8 8 145 146 146 147 8 8 8 200 8 8 8 8 8 415 416 463 464 465 466 463 464 465 466 463 464 465 466 417 418 200 8 8 8 200 200 200 200 8 8 8 439 440 441
428 429 430 8 8 8 8 8 8 8 277 278 8 8 8 8 8 8 8 8 8 145 146 180 153 124 8 409 410 411 412 8 8 8 421 422 469 470 471 472 469 470 471 472 469 470 471 472 423 424 8 200 200 200 200 200 368 369 8 8 8 445 446 447
411 412 8 8 8 409 410 411 412 8 8 8 8 8 8 114 8 8 8 8 139 166 146 147 8 8 8 415 416 417 418 8 8 8 427 428 475 476 477 478 475 476 477 478 475 476 477 478 429 430 8 8 200 200 200 8 374 375 8 8 8 451 452 453
417 418 8 409 410 385 386 387 388 411 412 8 8 8 8 8 409 410 411 412 145 146 146 147 8 8 8 421 422 423 424 8 241 242 8 8 481 482 483 484 481 482 483 484 481 482 483 484 8 8 8 8 200 200 8 8 380 381 8 8 119 8 409 410
423 424 8 415 416 391 392 393 394 417 418 8 8 8 110 8 415 416 417 418 145 146 180 153 8 8 8 427 428 429 430 8 247 248 8 8 427 428 429 430 427 428 429 430 427 428 429 430 8 8 8 8 200 200 8 8 8 8 8 8 237 8 415 416
429 430 8 421 422 397 398 399 400 423 424 8 8 110 110 110 421 422 423 424 145 146 147 8 8 119 8 368 369 8 8 8 8 8 8 8 8 8 8 8 8 8 8 8 8 125 8 8 8 271 272 200 200 8 433 434 435 436 8 112 243 244 421 422
411 412 8 427 428 403 404 405 406 429 430 8 8 110 110 8 427 428 429 139 166 146 147 8 8 8 8 374 375 8 8 409 410 411 412 8 8 8 8 8 8 8 8 8 8 8 8 8 8 277 278 200 200 8 439 440 441 442 8 8 249 250 427 428
417 418 8 8 8 427 428 429 430 125 8 8 110 110 110 8 8 8 8 145 146 146 147 8 8 8 8 380 381 8 8 415 416 417 418 8 8 8 8 8 110 110 8 8 8 409 410 411 412 8 8 200 200 8 445 446 447 448 8 8 409 410 411 412
423 424 8 8 8 8 8 8 8 8 8 8 8 110 110 8 8 8 8 145 146 180 153 8 8 8 8 8 8 8 8 421 422 423 424 8 110 110 8 110 110 110 8 8 8 415 416 417 418 8 8 8 200 8 451 452 453 454 241 242 415 416 417 418
429 430 114 8 8 8 8 8 8 8 8 8 8 8 8 8 8 8 8 145 146 147 271 272 8 8 8 8 8 8 8 427 428 429 430 8 8 110 110 110 8 8 8 8 8 421 422 423 424 8 8 8 200 8 8 8 8 8 247 248 421 422 423 424
411 412 409 410 411 412 409 410 411 412 409 410 411 283 285 285 285 286 8 145 146 147 277 278 8 8 8 8 8 8 8 8 8 8 8 8 8 8 8 8 8 8 8 8 8 427 428 429 430 8 8 8 200 8 8 8 8 8 8 8 427 428 429 430
417 418 415 416 417 418 415 416 417 418 415 416 417 418 8 8 8 8 253 145 146 147 8 8 410 411 412 410 411 412 410 411 412 410 411 412 410 411 412 410 411 412 410 411 412 410 411 412 410 411 412 410 411 412 410 411 412 410 411 412 410 411 412 410