391 392 393 394 391 392 393 394 391 392 393 394 391 392 393 394 391 392 393 394 391 392 393 394 391 392 393 394 391 392 393 394 391 392 393 394 391 392 393 394 391 392 393 394 391 392 393 394 391 392 393 394 391 392 393 394 391 392 393 394 391 392 393 394
397 398 399 400 397 398 399 400 397 398 399 400 397 398 399 400 397 398 399 400 397 398 399 400 397 398 399 400 397 398 399 400 397 398 399 400 397 398 399 400 397 398 399 400 397 398 399 400 397 398 399 400 397 398 399 400 397 398 399 400 397 398 399 400
403 404 405 406 403 404 405 406 403 404 405 406 403 404 405 406 403 404 405 406 403 404 405 406 403 404 405 406 403 404 405 406 403 404 405 406 403 404 405 406 403 404 405 406 403 404 405 406 403 404 405 406 403 404 405 406 403 404 405 406 403 404 405 406
427 428 429 430 427 428 429 430 427 428 429 430 427 428 429 430 427 428 429 430 427 428 429 430 427 428 429 430 427 428 429 430 427 428 429 430 427 428 429 430 427 428 429 430 427 428 429 430 427 428 429 430 427 428 429 430 427 428 429 430 427 428 429 430
435 436 217 8 8 8 8 8 8 8 8 8 8 8 8 8 8 8 8 8 8 8 8 8 8 8 8 8 8 8 8 8 8 8 8 8 8 8 8 8 8 8 8 8 8 8 8 8 8 8 8 8 8 8 8 8 8 8 8 8 8 8 262 263
441 442 8 8 8 139 141 8 8 139 141 139 140 140 141 139 140 140 140 140 140 140 140 140 140 140 140 140 140 140 140 140 140 140 140 140 140 140 140 140 140 140 140 140 140 140 140 140 140 140 140 140 141 8 8 187 8 8 8 8 8 8 268 269
447 448 8 139 143 142 144 140 141 151 153 145 146 146 147 145 146 146 146 146 146 146 146 146 146 146 146 146 146 146 146 146 146 146 146 146 146 146 146 146 146 146 146 146 146 146 146 146 146 146 146 146 147 8 8 8 8 409 410 411 412 409 410 411
453 454 8 151 176 154 156 152 153 8 8 151 152 152 153 151 152 152 152 152 152 152 152 152 152 152 152 152 152 152 152 152 152 152 152 152 152 152 152 152 152 152 152 152 152 152 152 152 152 152 154 146 147 8 8 8 8 415 416 417 418 415 416 417
8 239 8 8 8 151 153 8 8 8 8 409 410 411 412 8 8 8 8 8 8 8 8 110 8 8 8 8 8 8 8 8 8 8 8 8 8 8 8 8 8 8 8 8 8 8 8 8 273 274 145 146 147 8 8 409 410 457 458 459 460 457 458 459
242 433 434 435 436 8 8 139 141 8 8 415 416 417 418 8 8 110 110 110 8 8 8 8 8 8 8 8 8 193 194 195 8 8 8 8 8 8 8 8 8 8 8 8 8 8 8 8 279 280 169 170 171 8 8 415 416 463 464 465 466 463 464 465
248 439 440 441 442 8 8 151 153 8 8 421 422 423 424 8 8 8 8 8 262 263 8 8 8 8 8 8 8 199 200 201 8 110 110 409 410 411 412 409 410 411 412 409 410 411 412 8 8 8 169 170 171 110 110 421 422 469 470 471 472 469 470 471
8 445 446 447 448 8 8 8 8 8 8 427 428 429 430 8 8 8 8 8 268 269 8 409 410 411 412 8 8 205 206 207 110 409 410 385 386 387 388 385 386 387 388 385 386 387 388 411 412 8 169 170 171 8 8 427 428 475 476 477 478 475 476 477
8 451 452 453 454 8 8 8 8 139 141 8 8 8 8 8 8 8 8 8 8 8 8 415 416 417 418 8 8 8 8 8 8 415 416 391 392 393 394 391 392 393 394 391 392 393 394 417 418 8 169 170 171 8 8 367 8 481 482 483 484 481 482 483
411 251 8 8 8 368 369 8 8 145 147 8 8 8 8 8 8 8 8 8 8 8 8 421 422 423 424 8 8 8 8 8 8 421 422 397 398 399 400 397 398 399 400 397 398 399 400 423 424 8 169 170 171 8 8 373 8 427 428 429 430 427 428 429
417 418 8 8 110 374 375 8 8 151 158 141 8 8 8 409 410 411 412 409 410 411 412 427 428 429 430 8 433 434 435 436 8 427 428 403 404 405 406 403 404 405 406 403 404 405 406 429 430 8 169 170 171 8 8 379 8 8 8 8 8 8 239 8
423 424 8 8 8 380 381 8 8 110 151 153 8 8 8 415 416 417 418 415 416 417 418 8 8 8 8 8 439 440 441 442 8 8 8 427 428 429 430 427 428 429 430 427 428 429 430 8 8 8 169 170 171 8 8 8 8 8 8 8 8 8 8 260
429 430 8 8 8 8 8 8 8 8 8 110 110 409 410 457 458 459 460 457 458 459 460 411 412 8 8 8 445 446 447 448 8 8 8 8 8 8 8 8 8 8 8 8 8 110 110 8 8 8 169 170 171 8 8 8 8 8 8 8 8 8 8 266
411 412 8 8 8 193 194 194 194 194 194 195 8 415 416 463 464 465 466 463 464 465 466 417 418 8 8 8 451 452 453 454 8 8 367 8 8 8 8 8 8 110 8 8 8 8 8 8 8 8 169 173 171 8 8 8 8 8 187 8 8 8 265 8
417 418 8 8 8 199 200 200 200 200 200 201 8 421 422 469 470 471 472 469 470 471 472 423 424 8 8 8 8 8 8 8 8 8 373 8 8 8 8 8 8 8 8 8 8 8 8 8 8 8 175 176 177 8 8 8 8 4 5 5 5 5 5 5
423 424 8 8 8 199 200 200 200 200 200 201 8 427 428 475 476 477 478 475 476 477 478 429 430 8 8 8 8 8 8 8 8 8 379 8 8 8 8 8 8 8 8 4 5 5 5 5 5 5 5 5 5 5 5 5 5 15 11 11 11 11 11 11
429 430 8 8 8 205 206 206 206 206 206 207 8 8 8 481 482 483 484 481 482 483 484 8 8 8 8 8 273 274 8 8 4 5 5 5 5 5 5 5 5 5 5 15 11 11 11 11 11 11 11 11 11 11 11 11 11 11 11 37 38 38 38 38
410 411 412 409 410 411 412 8 8 8 8 8 8 8 8 427 428 429 430 427 428 429 430 8 8 8 8 8 279 280 8 8 9 11 11 11 11 11 11 11 11 11 11 11 11 37 38 38 38 38 38 38 38 38 38 38 38 38 38 40 44 44 44 44
416 417 418 415 416 417 418 8 8 8 8 8 193 194 195 8 8 8 8 8 8 8 8 8 8 8 8 8 8 8 4 5 15 11 11 37 38 38 38 38 38 38 38 38 38 40 44 44 44 44 44 44 44 44 44 44 44 44 44 44 44 44 61 62
458 459 460 457 458 459 460 411 412 8 8 8 199 200 201 8 8 8 8 8 8 8 8 8 8 8 4 5 5 5 15 11 11 11 37 40 44 44 44 44 44 44 44 44 44 44 44 44 44 44 44 44 44 44 44 44 61 62 62 62 62 62 64 68
464 465 466 463 464 465 466 417 418 8 8 8 205 206 207 8 8 8 8 8 8 8 8 8 4 5 15 11 11 11 11 11 37 38 40 61 62 62 62 62 62 62 62 62 62 62 62 62 62 62 62 62 62 62 62 62 64 68 68 68 68 68 68 68
470 471 472 469 470 471 472 423 424 433 434 435 436 8 8 8 8 8 8 8 8 8 8 4 15 11 11 11 37 38 38 38 40 61 62 64 68 68 68 68 68 68 68 68 68 68 68 68 68 68 68 68 68 68 68 68 68 78 74 74 74 74 74 74
476 477 478 475 476 477 478 429 430 439 440 441 442 8 367 8 8 8 8 8 8 8 4 15 11 11 11 37 40 44 44 44 61 64 68 78 74 74 74 74 74 74 74 74 74 74 74 74 74 74 74 74 74 74 74 74 74 75 44 44 44 44 44 44
482 483 484 481 482 483 484 8 8 445 446 447 448 8 373 8 8 8 8 8 8 4 15 11 11 37 38 40 44 44 61 62 64 78 74 75 44 44 44 44 44 44 44 44 44 44 44 44 44 44 44 44 44 44 44 44 44 44 44 44 54 50 50 50
428 429 430 427 428 429 430 8 8 451 452 453 454 8 379 8 8 8 8 4 5 15 11 11 37 40 44 44 44 61 64 68 78 75 44 44 44 44 44 44 44 44 44 54 50 50 50 50 50 50 50 50 50 50 50 50 50 50 50 50 51 11 11 11
8 8 255 8 8 8 8 8 8 8 8 8 8 8 8 8 8 8 8 9 11 11 11 37 40 44 44 61 62 64 68 78 75 44 44 44 54 50 50 50 50 50 50 51 11 11 11 11 11 11 11 11 11 11 11 11 11 11 11 11 11 1 17 17
412 265 8 8 8 8 8 8 110 110 8 8 8 4 5 5 5 5 5 15 11 11 37 40 44 44 61 64 68 68 78 75 44 54 50 50 51 11 11 11 11 11 11 11 1 17 17 17 17 17 17 17 17 17 17 17 17 17 17 17 17 18 8 239
418 8 8 8 8 8 8 8 8 110 8 4 5 15 11 11 11 11 11 11 37 38 40 44 44 61 64 78 74 74 75 44 54 51 11 11 11 1 17 17 17 17 17 17 8 8 8 8 8 8 163 164 165 8 8 8 409 410 411 412 409 410 411 412
424 8 8 8 8 8 8 8 8 8 8 10 11 11 37 38 38 38 38 38 40 44 61 62 62 64 78 75 44 44 44 54 51 11 1 17 17 18 8 8 8 8 8 8 8 8 8 8 8 8 145 173 147 8 8 8 415 416 417 418 415 416 417 418
430 262 263 8 8 8 8 4 5 5 5 15 11 37 40 44 44 44 44 61 62 62 64 68 68 78 75 44 44 54 50 51 11 1 8 8 8 8 8 8 8 110 110 8 8 193 194 195 8 8 145 146 147 8 409 410 457 458 459 460 457 458 459 460
8 268 269 8 4 5 5 15 11 11 11 11 37 40 44 61 62 62 62 64 68 68 78 74 74 75 44 54 50 51 11 11 11 7 8 8 8 8 8 110 8 8 8 8 8 199 200 201 8 8 145 146 147 8 415 416 463 464 465 466 463 464 465 466
5 5 5 5 15 11 11 11 37 38 38 38 40 61 62 64 68 68 68 78 74 74 75 44 54 50 50 51 11 11 1 17 17 18 8 8 8 8 8 8 8 8 8 8 8 205 206 207 8 8 145 146 147 8 421 422 469 470 471 472 469 470 471 472
11 11 11 11 11 37 38 38 40 44 44 44 61 68 68 78 74 74 74 75 44 44 44 54 51 11 11 11 1 17 18 8 8 8 8 8 8 8 8 8 8 8 8 409 410 411 412 8 8 110 145 146 147 8 427 428 475 476 477 478 475 476 477 478
38 38 38 38 38 40 44 44 44 44 61 62 64 78 75 54 50 50 50 50 50 50 50 51 11 1 17 17 8 8 8 8 8 433 434 435 436 8 8 8 8 409 410 385 386 387 388 411 412 8 145 146 147 8 8 8 481 482 483 484 481 482 483 484
44 44 44 44 44 44 44 44 44 44 73 74 74 75 54 51 11 11 11 11 11 11 11 11 11 7 8 8 8 241 242 8 8 439 440 441 442 8 8 8 8 415 416 391 392 393 394 417 418 8 145 146 147 8 241 242 427 428 429 430 427 428 429 430
44 44 44 44 44 44 44 44 44 44 44 44 54 50 51 11 1 17 17 17 17 17 17 17 17 18 8 8 8 247 248 8 8 445 446 447 448 8 8 8 8 421 422 397 398 399 400 423 424 8 145 146 147 8 247 248 8 8 8 110 110 8 8 8
44 44 44 44 44 44 44 44 54 50 50 50 51 11 11 11 7 8 8 8 8 8 8 8 8 8 8 8 8 8 8 8 8 451 452 453 454 8 8 110 8 427 428 403 404 405 406 429 430 8 145 146 147 8 8 8 8 8 110 8 8 254 409 410
44 44 44 44 44 44 54 50 51 11 11 11 11 1 17 17 18 8 8 8 8 8 8 368 369 8 8 8 8 8 8 8 8 8 8 8 265 8 8 110 110 8 8 427 428 429 430 8 110 8 145 146 147 8 8 187 8 8 8 8 8 110 415 416
50 50 50 50 50 50 51 11 1 17 17 17 17 18 409 410 411 412 409 410 411 412 8 374 375 8 8 8 8 139 141 8 8 8 8 8 8 8 8 8 8 8 8 367 8 8 110 8 8 8 145 146 147 8 8 8 8 8 409 410 411 412 421 422
11 11 11 11 11 11 11 11 7 8 8 8 409 410 385 386 387 388 385 386 387 388 411 380 381 8 8 8 8 151 153 8 8 8 8 8 8 110 110 8 8 8 8 373 8 8 8 8 8 8 145 146 147 8 8 8 8 8 415 416 417 418 427 428
17 17 17 17 17 17 17 17 18 8 8 8 415 416 391 392 393 394 391 392 393 394 417 418 8 8 8 8 8 8 8 139 140 140 140 140 140 140 141 8 8 8 8 379 8 8 8 8 8 8 145 146 147 8 8 8 8 8 421 422 423 424 409 410
411 412 8 8 8 255 8 8 8 8 8 8 421 422 397 398 399 400 397 398 399 400 423 424 8 8 8 8 139 141 8 145 146 146 146 146 146 146 147 8 8 8 8 8 8 8 8 8 8 8 145 146 147 8 8 8 8 8 427 428 429 430 415 416
417 418 8 8 8 8 8 273 274 110 8 8 427 428 403 404 405 406 403 404 405 406 429 430 139 140 141 8 145 147 8 151 152 152 152 152 152 152 153 8 139 140 141 8 8 163 164 165 8 8 145 146 147 110 8 8 8 8 8 8 8 8 421 422
423 424 8 8 8 8 8 279 280 110 8 8 8 8 427 428 429 430 427 428 429 430 8 8 145 146 147 8 151 153 8 8 8 8 8 8 8 8 8 8 151 155 153 8 8 169 170 171 8 8 145 146 147 8 8 8 8 8 8 8 8 8 427 428
429 430 256 8 8 8 8 8 8 8 8 110 8 8 8 8 8 8 8 8 8 8 8 8 151 152 153 8 409 410 411 412 409 410 411 412 409 410 411 412 8 8 8 8 110 175 176 177 8 8 151 152 153 8 8 8 8 139 141 8 8 8 409 410
409 410 411 412 409 410 411 412 409 410 411 412 8 8 8 367 8 8 8 8 8 8 8 8 8 8 409 410 385 386 387 388 385 386 387 388 385 386 387 388 411 412 8 8 8 8 139 141 8 8 139 140 141 8 8 8 8 151 153 8 8 110 415 416
415 416 417 418 415 416 417 418 415 416 417 418 8 8 8 373 8 8 8 8 193 194 195 8 8 8 415 416 391 392 393 394 391 392 393 394 391 392 393 394 417 418 8 8 8 8 151 153 8 139 166 167 168 141 8 8 239 8 8 8 8 8 421 422
457 458 459 460 457 458 459 460 457 458 459 460 411 412 8 379 8 8 8 8 199 200 201 8 8 8 421 422 397 398 399 400 397 398 399 400 397 398 399 400 423 424 8 8 8 8 8 8 8 145 172 173 174 147 8 8 8 8 8 193 194 195 427 428
463 464 465 466 463 464 465 466 463 464 465 466 417 418 8 8 8 8 8 8 205 206 207 8 8 8 427 428 403 404 405 406 403 404 405 406 403 404 405 406 429 430 8 8 8 8 8 8 8 151 178 179 180 153 8 8 8 8 8 199 200 201 409 410
469 470 471 472 469 470 471 472 469 470 471 472 423 424 8 8 8 8 8 8 8 8 8 8 8 8 256 427 427 428 429 430 427 428 429 430 427 428 429 430 8 8 8 8 8 8 8 8 8 8 151 152 153 8 8 8 8 8 8 205 206 207 415 416
475 476 477 478 475 476 477 478 475 476 477 478 429 430 8 110 8 8 409 410 411 412 8 8 8 8 8 8 8 8 8 8 8 8 8 8 8 8 8 8 8 8 433 434 435 436 8 8 8 8 8 8 8 8 8 8 8 8 8 8 8 8 421 422
481 482 483 484 481 482 483 484 481 482 483 484 8 110 110 8 8 8 415 416 417 418 8 8 8 110 8 8 8 8 8 8 8 193 194 194 194 194 194 194 195 8 439 440 441 442 8 8 8 8 8 8 8 8 8 163 164 165 8 8 8 8 427 428
427 428 429 430 427 428 429 430 427 428 429 430 8 8 8 8 8 8 421 422 423 424 8 8 8 8 8 8 110 367 8 8 8 199 200 200 200 200 200 200 201 8 445 446 447 448 8 8 8 8 8 8 8 8 8 169 170 171 8 8 8 368 369 253
260 261 8 8 8 8 8 8 8 8 8 8 8 8 8 8 8 8 427 428 429 430 8 8 8 8 8 8 8 373 8 8 8 205 206 206 206 206 206 206 207 8 451 452 453 454 8 8 8 8 8 8 8 187 8 175 176 177 8 8 8 374 375 8
266 267 8 8 8 8 8 8 8 8 8 8 8 8 8 8 8 253 8 8 8 8 8 8 8 8 8 8 8 379 8 110 110 8 8 8 8 8 8 8 8 8 8 8 8 8 8 8 8 239 8 8 8 8 8 8 8 8 8 8 8 380 381 8
409 410 411 412 409 410 411 412 409 410 411 412 409 410 411 412 409 410 411 412 409 410 411 412 409 410 411 412 409 410 411 412 409 410 411 412 409 410 411 412 409 410 411 412 409 410 411 412 409 410 411 412 409 410 411 412 409 410 411 412 409 410 411 412
385 386 387 388 385 386 387 388 385 386 387 388 385 386 387 388 385 386 387 388 385 386 387 388 385 386 387 388 385 386 387 388 385 386 387 388 385 386 387 388 385 386 387 388 385 386 387 388 385 386 387 388 385 386 387 388 385 386 387 388 385 386 387 388
391 392 393 394 391 392 393 394 391 392 393 394 391 392 393 394 391 392 393 394 391 392 393 394 391 392 393 394 391 392 393 394 391 392 393 394 391 392 393 394 391 392 393 394 391 392 393 394 391 392 393 394 391 392 393 394 391 392 393 394 391 392 393 394
397 398 399 400 397 398 399 400 397 398 399 400 397 398 399 400 397 398 399 400 397 398 399 400 397 398 399 400 397 398 399 400 397 398 399 400 397 398 399 400 397 398 399 400 397 398 399 400 397 398 399 400 397 398 399 400 397 398 399 400 397 398 399 400
403 404 405 406 403 404 405 406 403 404 405 406 403 404 405 406 403 404 405 406 403 404 405 406 403 404 405 406 403 404 405 406 403 404 405 406 403 404 405 406 403 404 405 406 403 404 405 406 403 404 405 406 403 404 405 406 403 404 405 406 403 404 405 406