385 386 387 388 385 386 387 388 385 386 387 388 385 386 387 388 385 386 387 388 385 386 387 388 385 386 387 388 385 386 387 388 385 386 387 388 385 386 387 388 385 386 387 388 385 386 387 388 385 386 387 388 411 8 169 173 171 8 8 8 8 410 385 386
391 392 393 394 391 392 393 394 391 392 393 394 391 392 393 394 391 392 393 394 391 392 393 394 391 392 393 394 391 392 393 394 391 392 393 394 391 392 393 394 391 392 393 394 391 392 393 394 391 392 393 394 417 418 169 146 171 8 370 8 415 416 391 392
397 398 399 400 397 398 399 400 397 398 399 400 397 398 399 400 397 398 399 400 397 398 399 400 397 398 399 400 397 398 399 400 397 398 399 400 397 398 399 400 397 398 399 400 397 398 399 400 397 398 399 400 423 424 169 146 171 8 376 8 421 422 397 398
403 404 405 406 403 404 405 406 403 404 405 406 403 404 405 406 403 404 405 406 403 404 405 406 403 404 405 406 403 404 405 406 403 404 405 406 403 404 405 406 403 404 405 406 403 404 405 406 403 404 405 406 429 8 169 146 171 8 382 8 8 428 403 404
8 428 429 8 8 428 429 8 8 428 429 8 8 428 429 8 8 428 429 8 8 428 429 8 8 428 429 8 8 428 429 8 8 428 429 8 8 428 429 8 8 428 429 8 8 428 429 8 8 428 429 8 8 8 169 146 171 8 8 8 8 410 411 428
8 8 8 367 8 8 260 261 8 8 8 8 8 8 8 8 8 410 411 8 8 8 8 8 8 8 8 8 8 8 8 8 8 777 778 847 848 849 8 8 8 8 8 8 110 8 8 8 8 8 8 8 8 8 169 146 171 8 8 8 415 416 417 410
8 8 8 373 8 8 266 267 8 8 8 8 8 8 8 8 415 416 417 418 8 8 8 8 8 8 8 8 8 8 8 781 782 783 784 853 854 855 856 857 8 8 368 369 8 8 8 8 8 110 110 8 8 110 169 146 171 8 8 8 421 422 397 398
8 8 8 379 8 8 8 8 8 8 8 8 8 8 254 410 457 458 459 460 411 8 8 8 110 8 8 8 8 8 8 787 788 789 790 859 860 861 862 863 8 8 374 375 8 8 8 8 8 8 110 8 8 8 169 146 171 8 8 271 272 428 403 404
8 8 110 8 8 8 4 14 14 14 14 14 14 6 415 416 463 464 465 466 417 418 8 8 8 8 8 8 8 8 8 793 794 795 796 865 866 867 868 869 8 8 380 381 1003 1004 1005 1006 1007 1008 942 8 8 8 169 146 171 8 8 277 278 8 8 428
14 14 14 14 14 14 15 11 11 11 11 11 11 7 421 422 469 470 471 472 423 424 8 8 8 8 8 8 8 8 110 799 800 801 802 871 872 873 874 875 8 8 8 8 1009 1010 1011 1012 1013 1014 948 8 8 8 169 146 171 8 410 411 8 8 8 8
11 11 11 115 116 116 116 116 116 116 116 117 11 7 8 428 475 476 477 478 429 8 8 8 8 8 8 8 8 8 8 805 806 807 808 877 878 879 880 881 8 8 8 8 1015 1016 1017 1018 1019 1020 869 8 8 8 169 146 171 415 416 417 418 8 8 8
11 11 11 121 122 122 122 122 122 122 122 123 11 13 6 8 421 422 423 424 8 256 8 8 8 8 8 8 139 141 8 811 812 813 814 883 884 885 886 887 8 8 8 8 1021 1022 1023 1024 1025 1026 960 8 8 8 169 146 171 421 422 423 424 8 8 410
11 11 11 121 122 122 122 122 122 122 122 122 120 117 7 8 8 428 429 8 8 8 8 8 8 110 8 8 151 153 8 817 818 819 820 889 890 891 892 893 8 8 8 8 1027 1028 1029 1030 1031 1032 966 8 8 110 169 146 171 8 428 429 8 410 411 416
11 11 11 121 122 122 122 122 122 122 122 122 122 123 7 8 8 8 8 8 8 8 8 8 8 110 110 8 8 8 8 823 824 825 826 895 896 897 898 899 8 8 8 8 1033 1034 1035 1036 1037 1038 972 8 8 8 169 146 171 8 8 8 415 416 391 392
11 11 11 127 128 128 128 128 128 128 128 130 122 123 13 14 14 8 14 14 14 14 6 8 8 8 8 8 8 8 8 829 830 831 832 901 902 903 904 905 8 8 8 8 1039 1040 1041 1042 1043 1044 978 8 8 8 169 146 171 8 8 367 421 422 397 398
38 38 38 38 38 38 38 38 38 38 39 121 122 123 11 109 11 11 11 11 11 11 7 8 8 8 8 8 139 140 141 835 836 837 838 907 908 909 910 911 8 8 8 8 1045 1046 1047 1048 1049 1050 984 8 8 163 166 146 171 8 8 373 8 428 403 404
44 44 44 44 44 44 44 44 44 44 45 121 122 123 11 11 11 11 11 11 11 11 13 14 14 14 6 8 145 146 147 8 8 8 139 140 141 8 8 8 8 8 8 8 8 8 8 139 140 141 8 8 163 166 146 180 177 8 8 379 8 8 8 428
44 44 44 44 44 44 44 44 44 44 45 127 128 129 11 11 11 11 11 11 11 11 11 11 11 11 7 8 151 152 153 8 8 8 145 146 147 8 8 8 8 8 8 8 8 8 8 145 146 147 8 163 166 146 180 177 8 410 411 8 8 410 411 8
44 44 44 44 44 44 44 44 44 44 45 11 11 11 11 11 11 11 11 11 11 11 11 11 11 11 7 8 8 8 8 8 8 8 145 146 168 164 164 164 164 164 164 164 164 164 164 166 146 168 164 166 146 180 177 410 385 386 387 388 385 386 387 388
44 44 44 44 44 44 44 44 44 44 45 11 11 11 11 11 11 11 11 11 11 11 11 11 11 11 13 6 433 434 435 436 8 8 145 146 146 146 146 146 146 146 146 146 146 146 146 146 146 146 146 146 180 177 415 416 391 392 393 394 391 392 393 394
44 44 44 44 44 44 44 44 44 44 42 38 38 38 38 38 38 38 38 38 38 39 11 11 11 11 11 7 439 440 441 442 8 8 175 176 176 176 176 176 176 176 176 176 176 176 176 176 176 176 176 176 177 8 421 422 397 398 399 400 397 398 399 400
44 44 44 44 44 44 44 44 44 44 44 44 44 44 44 44 44 44 44 44 44 45 11 11 11 11 11 7 445 446 447 448 8 8 8 8 8 8 8 8 8 8 8 8 8 8 8 8 8 139 141 8 8 8 8 428 403 404 405 406 403 404 405 406
44 44 44 44 44 44 44 44 44 44 44 44 44 44 44 44 44 44 44 44 44 42 38 38 38 39 11 7 451 452 453 454 8 8 8 8 8 8 8 8 8 110 8 8 8 8 8 8 8 151 153 163 164 165 8 8 8 428 429 8 367 428 429 8
44 44 44 44 44 44 44 44 44 44 47 44 44 44 44 44 44 44 44 44 44 44 44 44 44 45 11 13 14 14 6 8 8 8 8 8 8 8 8 8 8 8 8 8 1003 1004 1005 1006 1007 1008 942 169 146 171 8 8 410 411 8 8 373 8 8 239
44 44 44 44 44 44 44 44 44 44 44 44 44 44 44 44 44 44 44 44 44 44 44 44 44 45 11 11 11 11 7 8 8 8 8 8 8 110 110 8 8 8 8 8 787 1010 1011 1012 1013 1014 948 175 176 177 8 415 416 417 418 8 379 8 8 8
44 44 44 44 44 44 44 44 44 44 44 44 44 44 44 44 44 44 44 44 44 44 44 44 44 45 11 11 11 11 7 8 8 8 8 8 8 8 8 110 8 8 8 8 1015 1016 1017 1018 1019 1020 869 8 110 110 410 457 458 459 460 411 410 411 8 8
44 44 44 44 44 44 44 44 44 44 44 44 44 44 44 44 44 44 44 44 44 44 44 44 44 42 39 11 11 11 13 6 8 8 8 8 8 8 8 8 8 8 8 8 1021 1022 1023 1024 1025 1026 960 8 8 415 416 463 464 465 466 417 386 387 410 411
44 44 44 44 44 44 44 44 44 44 44 44 44 44 44 44 44 44 44 44 44 44 44 44 44 44 45 11 11 11 11 7 8 8 8 8 8 8 8 8 8 8 8 8 1027 1028 1029 1030 1031 1032 966 8 8 421 422 469 470 471 472 423 392 393 398 387
44 44 44 44 44 44 44 44 44 44 44 44 44 44 44 44 44 44 44 44 44 44 44 44 44 44 45 11 11 11 11 13 14 14 14 14 6 8 8 8 8 8 8 8 1033 967 968 969 970 971 972 8 8 8 428 475 476 477 478 429 416 391 392 393
44 44 44 44 44 44 44 44 44 44 44 44 44 44 44 44 44 44 44 44 44 44 44 44 44 44 42 38 38 39 11 11 11 11 11 11 7 8 368 369 8 8 8 8 1039 991 992 993 994 995 996 8 8 8 8 421 422 423 424 421 422 397 398 399
44 44 44 44 44 44 44 44 44 44 44 44 44 44 44 44 44 44 44 44 44 44 44 44 44 44 44 44 44 45 11 11 11 11 11 11 7 8 374 375 8 8 8 8 1045 997 998 999 1000 1001 1002 8 8 8 8 8 428 429 8 8 428 403 404 405
44 44 44 44 44 44 44 44 44 44 44 44 44 44 44 44 44 44 44 44 44 44 44 44 44 44 44 44 44 45 11 11 11 11 11 11 7 8 380 381 8 8 8 8 8 8 8 8 8 8 8 8 8 139 141 8 8 8 8 8 8 253 428 429
44 44 44 44 44 44 44 44 44 44 44 44 44 44 44 44 44 44 44 44 44 44 44 44 44 44 44 44 44 42 39 11 11 11 11 11 7 8 8 8 8 8 8 8 8 8 8 110 8 488 8 8 8 151 153 8 8 8 8 8 8 410 411 8
44 44 44 44 44 44 44 44 44 44 44 44 44 44 44 44 44 44 44 44 44 44 44 44 44 44 44 44 44 44 42 39 11 11 11 11 13 14 14 14 14 6 8 8 8 8 8 8 493 494 495 8 8 193 194 194 194 194 195 8 415 416 417 418
44 44 44 44 44 44 44 44 44 44 44 44 44 44 44 44 44 44 44 44 44 44 44 44 44 44 44 44 44 44 44 45 11 11 11 11 11 11 11 11 11 13 14 14 14 6 8 8 499 500 501 8 8 199 200 200 200 200 200 8 421 422 423 424
44 44 44 44 44 44 44 44 44 44 44 44 44 44 44 44 44 44 44 44 44 44 44 44 44 44 44 44 44 44 44 42 38 38 39 11 11 11 11 11 11 11 11 11 11 13 6 8 505 506 507 8 8 199 200 200 200 200 200 8 8 428 429 8
44 44 44 44 44 44 44 44 44 44 44 44 44 44 44 44 44 44 44 44 44 44 44 44 44 44 44 44 44 44 44 44 44 44 42 39 11 11 11 11 11 11 11 11 11 11 13 6 511 512 513 8 8 205 206 206 206 206 207 8 410 411 8 8
44 44 44 44 44 44 44 44 44 44 44 44 44 44 44 44 44 44 44 44 44 44 44 44 44 44 44 44 44 44 44 44 44 44 44 42 38 38 38 39 11 11 11 11 11 11 11 7 517 518 519 8 8 8 8 8 8 8 8 415 416 417 217 8
44 44 44 44 44 44 44 44 44 44 44 44 44 44 44 44 44 44 44 44 44 44 44 44 44 44 44 44 54 50 50 50 50 52 44 44 44 44 44 42 39 11 11 11 11 11 11 7 523 524 525 8 193 200 195 8 8 8 8 421 422 423 424 8
44 44 44 44 44 44 44 44 44 44 44 44 44 44 44 44 44 44 44 44 44 44 44 44 44 50 50 50 51 85 86 86 87 43 44 44 44 44 44 44 42 38 38 39 11 11 11 13 6 8 8 8 199 200 200 200 195 8 8 8 428 429 8 8
44 44 44 44 44 44 44 44 44 44 44 44 44 44 44 44 44 44 44 44 44 44 44 44 45 85 86 86 86 88 92 92 93 43 44 44 44 44 44 44 44 44 44 42 39 11 11 11 7 8 8 8 205 200 200 200 200 195 8 8 8 8 410 411
44 44 44 44 44 44 44 44 44 44 44 44 44 44 44 44 44 44 44 44 44 44 44 44 45 91 92 92 92 92 92 92 93 49 50 50 52 44 44 47 44 44 44 44 45 11 11 11 13 6 8 8 8 205 200 200 200 200 8 8 410 385 386 387
44 44 44 44 44 44 44 44 44 44 44 44 44 44 44 44 44 44 44 44 44 44 44 44 45 91 92 92 92 92 92 92 90 86 87 11 43 44 44 44 44 44 44 44 45 11 11 11 11 7 8 8 8 110 200 200 200 200 8 415 416 391 392 393
44 44 44 44 44 44 44 44 44 44 44 44 44 44 44 44 44 44 44 44 44 44 44 44 45 91 92 92 92 92 92 92 92 92 93 11 43 44 44 44 44 44 44 44 45 11 11 11 11 13 14 6 110 8 205 200 200 207 8 421 422 397 398 399
44 44 44 44 44 44 44 44 44 44 44 44 44 44 44 44 44 44 44 44 44 44 44 44 45 91 92 92 92 92 92 92 92 92 93 11 43 44 44 44 44 44 44 44 45 11 11 11 11 11 11 7 8 8 8 200 200 8 8 8 428 403 404 405
44 44 44 44 44 44 44 44 44 44 44 44 44 44 44 44 44 44 44 44 44 44 44 44 45 97 98 98 100 92 92 92 92 92 93 37 40 44 44 44 44 44 44 44 42 39 11 11 11 11 11 7 8 8 8 205 207 8 370 8 8 8 428 429
44 44 44 44 44 44 44 44 44 44 44 44 44 44 44 44 44 44 44 44 44 44 44 44 42 38 39 11 97 98 98 98 98 98 99 43 44 44 44 44 44 44 44 44 44 45 11 11 11 11 11 13 6 8 8 8 8 8 376 8 8 8 239 410
44 44 44 44 44 44 44 44 44 44 44 44 44 44 44 44 44 44 44 44 44 44 44 44 44 44 45 11 11 11 11 11 11 37 38 40 44 44 44 44 44 44 44 44 44 45 11 11 11 11 11 11 7 8 8 8 8 8 382 8 8 410 385 386
44 44 44 44 44 44 44 44 44 44 44 44 44 44 44 44 44 44 44 44 44 44 44 44 44 44 42 38 38 38 38 38 38 40 44 44 44 44 44 44 44 44 44 44 44 45 11 11 11 11 11 11 7 8 8 8 8 8 8 8 415 416 391 392
44 44 44 44 44 44 44 44 44 44 44 44 44 44 44 44 44 44 44 44 44 44 44 44 44 44 44 44 44 44 44 44 44 44 44 44 44 44 44 44 44 44 44 44 44 45 11 11 11 11 11 11 7 8 8 8 8 8 8 251 421 422 397 398
44 44 44 44 44 44 44 44 44 44 44 44 44 44 44 44 44 44 44 44 44 44 44 44 44 44 44 44 44 44 44 44 44 44 44 44 44 44 44 44 44 44 44 44 44 45 11 11 11 11 11 11 13 6 8 8 8 8 8 8 8 428 403 404
44 44 44 44 44 44 44 44 44 44 44 44 44 44 44 44 44 44 44 44 44 44 44 44 44 44 44 44 44 44 44 44 44 44 44 44 44 44 44 44 44 44 44 44 44 45 11 11 11 11 11 11 11 7 8 8 8 8 8 8 273 274 8 428
44 44 44 44 44 44 44 44 44 44 44 44 44 44 44 44 44 44 44 44 44 44 44 44 44 44 44 44 44 44 44 44 44 44 44 44 44 44 44 44 44 44 44 44 44 42 38 39 11 11 11 11 11 7 8 8 8 110 8 8 279 280 8 410
44 44 44 44 44 44 44 44 44 44 44 44 44 44 44 44 44 44 44 44 44 44 44 44 44 44 44 44 44 44 44 44 44 44 44 44 44 44 44 44 44 44 44 44 44 44 44 45 11 11 11 11 11 7 8 8 8 8 8 8 8 410 385 386
44 44 44 44 44 44 44 44 44 44 44 44 44 44 44 44 44 44 44 44 44 44 44 44 44 44 44 44 44 44 44 44 44 44 44 44 44 44 44 44 44 44 44 44 44 44 44 45 11 11 11 11 11 7 241 242 8 8 8 8 415 416 391 392
44 44 44 44 44 44 44 44 44 44 44 44 44 44 44 44 44 44 44 44 44 44 44 44 44 44 44 44 44 44 44 44 44 44 44 44 44 44 44 44 44 44 44 44 44 44 44 45 11 11 11 11 11 7 247 248 8 410 411 8 421 422 397 398
44 44 44 44 44 44 44 44 44 44 44 44 44 44 44 44 44 44 44 44 44 44 44 44 44 44 44 44 44 44 44 44 44 44 44 44 44 44 44 44 44 44 44 44 44 44 44 45 11 11 11 11 11 7 8 410 385 386 387 388 411 428 403 404
44 44 44 44 44 44 44 44 44 44 44 44 44 44 44 44 44 44 44 44 44 44 44 44 44 44 44 44 44 44 44 44 44 44 44 44 44 44 44 44 44 44 44 44 44 44 44 45 11 11 11 11 11 7 415 416 391 392 393 394 417 418 8 428
44 44 44 44 44 44 44 44 44 44 44 44 44 44 44 44 44 44 44 44 44 44 44 44 44 44 44 44 44 44 44 44 44 44 44 44 44 44 44 44 44 44 44 44 44 44 44 45 11 11 11 11 11 7 421 422 397 398 399 400 423 424 8 410
44 44 44 44 44 44 44 44 44 44 44 44 44 44 44 44 44 44 44 44 44 44 44 44 44 44 44 44 44 44 44 44 44 44 44 44 44 44 44 44 44 44 44 44 44 44 44 45 11 11 11 11 11 7 8 428 403 404 405 406 429 410 385 386
44 44 44 44 44 44 44 44 44 44 44 44 44 44 44 44 44 44 44 44 44 44 44 44 44 44 44 44 44 44 44 44 44 44 44 44 44 44 44 44 44 44 44 44 44 44 44 45 11 11 11 11 11 7 8 488 8 428 429 8 415 416 391 392
44 44 44 44 44 44 44 44 44 44 44 44 44 44 44 44 44 44 44 44 44 44 44 44 44 44 44 44 44 44 44 44 44 44 44 44 44 44 44 44 44 44 44 44 44 44 44 45 11 11 11 11 11 7 493 494 495 8 262 263 421 422 397 398
44 44 44 44 44 44 44 44 44 44 44 44 44 44 44 44 44 44 44 44 44 44 44 44 44 44 44 44 44 44 44 44 44 44 44 44 44 44 44 44 44 44 44 44 44 44 44 45 11 11 11 11 11 7 499 500 501 8 268 269 8 428 403 404
44 44 44 44 44 44 44 44 44 44 44 44 44 44 44 44 44 44 44 44 44 44 44 44 44 44 44 44 44 44 44 44 44 44 44 44 44 44 44 44 44 44 44 44 44 44 44 45 11 11 11 11 11 7 505 506 507 8 8 8 8 8 8 428