8 277 280 430 8 427 428 429 430 427 428 429 430 224 225 430 370 8 8 169 146 171 8 8 409 410 385 386 387 388 385 386 387 388 385 386 387 388 385 386 387 388 385 386 387 388 385 386 387 388 385 386 387 388 385 386 387 388 385 386 387 388 385 386
411 412 409 410 411 412 409 410 411 412 409 410 411 230 231 8 376 8 163 166 146 171 8 8 415 416 391 392 393 394 391 392 393 394 391 392 393 394 391 392 393 394 391 392 393 394 391 392 393 394 391 392 393 394 391 392 393 394 391 392 393 394 391 392
417 418 415 416 417 418 415 416 417 418 415 416 417 418 8 8 382 8 169 146 180 177 8 8 421 422 397 398 399 400 397 398 399 400 397 398 399 400 397 398 399 400 397 398 399 400 397 398 399 400 397 398 399 400 397 398 399 400 397 398 399 400 397 398
459 460 457 458 459 460 457 458 459 460 457 458 459 460 411 412 8 8 169 146 171 163 164 165 427 428 403 404 405 406 403 404 405 406 403 404 405 406 403 404 405 406 403 404 405 406 403 404 405 406 403 404 405 406 403 404 405 406 403 404 405 406 403 404
465 466 463 464 465 466 463 464 465 466 463 464 465 466 417 418 8 163 166 146 171 169 170 171 8 8 427 428 429 430 427 428 429 430 427 428 429 430 427 428 429 430 427 428 429 430 427 428 429 430 427 428 429 430 427 428 429 430 427 428 429 430 427 428
471 472 469 470 471 472 469 470 471 472 469 470 471 472 423 424 8 169 146 146 171 175 176 177 8 200 8 8 8 8 8 110 8 8 8 8 8 8 8 8 8 8 8 8 8 8 8 8 8 8 8 8 8 487 488 489 8 8 8 8 8 8 409 410
477 478 475 476 477 478 475 476 477 478 475 476 477 478 429 430 8 169 146 170 150 8 8 8 8 200 200 200 200 8 8 8 110 110 8 8 8 8 8 8 8 409 410 411 412 8 8 8 200 8 200 200 8 493 494 495 8 8 8 8 110 8 415 416
459 460 457 458 459 460 457 458 459 460 457 458 459 460 411 412 8 169 146 146 171 8 8 8 8 8 200 200 200 8 8 8 8 110 8 368 369 8 8 8 8 415 416 417 418 8 8 200 200 200 200 200 8 499 500 501 8 8 409 410 411 412 421 422
465 466 463 464 465 466 463 464 465 466 463 464 465 466 417 418 112 175 178 146 171 8 8 8 409 410 411 412 409 410 411 412 8 8 8 374 375 8 8 409 410 457 458 459 460 411 412 8 200 200 200 8 8 505 506 507 8 8 415 416 417 418 427 428
471 472 469 470 471 472 469 470 471 472 469 470 471 472 423 424 8 8 169 146 171 8 409 410 385 386 387 388 385 386 387 388 411 412 8 380 381 8 8 415 416 463 464 465 466 417 418 8 200 200 200 110 110 511 512 513 409 410 457 458 459 460 411 412
477 478 475 476 477 478 475 476 477 478 475 476 477 478 429 430 8 8 169 146 171 8 415 416 391 392 393 394 391 392 393 394 417 418 8 8 8 8 8 421 422 469 470 471 472 423 424 8 8 200 200 8 8 517 518 519 415 416 463 464 465 466 417 418
459 460 457 458 459 460 457 458 459 460 457 458 459 460 411 412 8 8 169 146 168 165 421 422 397 398 399 400 397 398 399 400 423 424 8 8 8 8 8 427 428 475 476 477 478 429 430 8 8 8 110 8 8 523 524 525 421 422 469 470 471 472 423 424
465 466 463 464 465 466 463 464 465 466 463 464 465 466 417 418 8 8 175 178 146 171 427 428 403 404 405 406 403 404 405 406 429 430 8 8 8 409 410 411 412 481 482 483 484 8 8 8 1003 1004 1005 1006 1007 1008 857 8 427 428 475 476 477 478 429 430
471 472 469 470 471 472 469 470 471 472 469 470 471 472 423 424 110 8 8 169 146 168 165 8 427 428 429 430 427 428 429 433 434 435 436 8 8 415 416 417 418 427 428 429 430 427 8 8 1009 1010 1011 1012 1013 1014 863 8 8 8 481 482 483 484 409 410
477 478 475 476 477 478 475 476 477 478 475 476 477 478 429 430 8 110 8 169 146 146 168 165 8 8 8 8 8 8 8 439 440 441 442 8 8 421 422 423 424 8 8 273 274 8 8 112 1015 1016 1017 1018 1019 1020 881 8 8 8 427 428 429 430 415 416
459 460 457 458 459 460 457 458 459 460 457 458 459 460 411 412 8 110 8 175 178 146 146 168 165 8 8 8 8 8 8 445 446 447 448 8 8 427 428 429 430 8 8 279 280 8 8 8 1021 1022 1023 1024 1025 1026 887 8 8 8 8 110 110 8 421 422
465 466 463 464 465 466 463 464 465 466 463 464 465 466 417 418 8 8 8 8 175 178 146 146 168 164 165 8 8 8 8 451 452 453 454 8 8 8 8 8 8 8 8 110 8 8 8 8 1027 961 962 963 964 965 893 8 8 8 8 8 8 8 427 428
471 472 469 470 471 472 469 470 471 472 469 470 471 472 423 424 8 8 8 8 8 175 178 146 146 146 168 164 164 165 8 8 8 8 8 8 8 8 8 8 8 8 8 8 110 8 110 110 1033 985 986 987 988 989 899 8 8 8 8 139 140 140 140 140
477 478 475 476 477 478 475 476 477 478 475 476 477 478 429 430 8 8 409 410 411 412 175 176 178 146 146 146 146 168 164 164 164 165 8 8 8 8 8 8 8 8 8 8 8 8 8 8 1039 991 992 993 994 995 996 8 8 8 139 142 146 146 146 146
483 484 481 482 483 484 481 482 483 484 481 482 483 484 8 8 8 8 415 416 417 418 8 8 175 176 176 178 146 146 146 146 146 168 164 164 164 164 164 164 165 8 8 8 8 110 367 8 1045 997 998 999 1000 1001 1002 8 8 139 142 146 156 176 176 176
429 430 427 428 429 253 427 428 429 430 427 428 429 430 8 8 8 8 421 422 423 424 8 8 8 241 242 175 176 176 176 154 146 146 146 146 170 170 170 170 168 165 8 8 8 8 373 8 8 8 8 8 8 8 8 8 139 142 146 156 153 8 8 8
255 8 8 8 8 8 8 8 8 8 8 8 8 8 110 8 8 8 427 428 429 430 8 8 8 247 248 8 8 8 8 148 146 146 156 176 176 176 176 178 170 168 165 8 8 8 379 8 409 8 8 8 8 8 8 139 142 146 156 153 8 239 110 410
8 273 274 8 370 8 8 8 8 8 163 164 140 140 140 140 140 140 140 140 140 140 140 140 140 140 140 140 140 140 140 142 146 156 153 433 434 435 436 175 178 170 168 165 8 8 8 8 8 8 110 110 8 8 139 142 170 156 153 8 8 410 385 386
8 279 280 8 376 8 8 8 163 164 166 146 146 146 146 146 146 146 146 146 146 146 146 146 146 146 146 146 146 146 146 146 156 153 8 439 440 441 442 8 175 178 146 168 165 8 8 8 8 8 8 8 8 139 142 146 156 153 8 8 415 416 391 392
8 8 8 8 382 8 163 164 166 146 146 146 180 152 152 152 152 152 152 152 152 152 152 152 152 152 152 152 152 152 152 152 153 8 8 445 446 447 448 255 8 175 178 146 168 164 164 164 164 140 140 140 140 142 146 156 153 8 409 410 457 458 459 460
8 8 8 110 110 163 166 146 146 146 180 176 177 8 8 8 8 8 8 8 8 8 8 8 8 8 8 8 8 8 8 8 8 8 8 451 452 453 454 8 8 8 175 178 146 146 170 170 170 170 170 146 146 146 156 153 8 8 415 416 463 464 465 466
164 164 164 164 164 166 146 146 180 176 177 8 8 8 110 110 8 8 8 4 14 14 14 14 14 6 8 8 8 8 8 8 8 8 253 8 8 8 8 8 8 8 8 175 152 152 152 154 146 146 146 156 152 152 153 8 8 8 421 422 469 470 471 472
146 146 146 146 146 146 180 176 177 8 8 8 4 14 14 14 6 8 4 15 11 11 11 11 11 13 6 8 8 8 8 8 8 8 8 8 8 8 8 8 8 8 8 8 110 8 8 151 154 146 156 153 139 141 8 8 8 8 427 428 475 476 477 478
176 176 176 176 176 176 177 8 8 8 8 4 15 11 11 11 13 14 15 11 11 11 11 11 11 11 13 14 14 6 8 8 8 8 8 8 8 8 8 8 110 110 8 8 8 8 8 8 169 170 171 139 166 147 8 8 8 8 409 410 457 482 483 484
430 241 242 8 409 410 411 412 8 8 4 15 11 11 11 11 37 38 38 38 38 38 38 38 39 11 11 11 11 13 6 8 8 8 8 8 8 8 8 8 8 8 8 8 8 8 8 8 169 170 171 151 152 153 8 8 8 8 415 416 463 464 465 466
430 247 248 8 415 416 417 418 8 8 10 11 11 11 11 11 43 44 44 44 44 44 44 44 45 11 11 11 11 11 7 8 8 8 8 8 8 8 1003 1004 1005 1006 1007 1008 857 8 8 8 169 170 171 8 8 8 8 8 370 8 421 422 469 470 471 472
253 8 8 8 421 422 423 424 8 4 15 11 11 11 11 37 40 44 44 44 44 44 44 44 45 11 11 11 11 11 7 8 8 8 8 8 8 8 1009 1010 1011 1012 1013 1014 863 8 8 8 169 170 171 8 8 8 8 8 376 8 427 428 475 476 477 478
411 412 8 367 427 428 429 430 4 15 11 11 37 38 38 40 44 44 44 44 44 44 44 44 42 38 39 11 11 11 7 8 370 8 8 8 8 8 1015 1016 1017 1018 1019 1020 881 8 8 8 169 170 171 8 8 110 8 110 382 8 409 410 457 482 483 484
417 418 8 373 8 8 8 8 9 11 11 11 43 44 44 44 44 44 44 44 44 44 44 44 44 44 45 11 11 11 7 8 376 8 8 8 8 8 1021 1022 1023 1024 1025 1026 887 8 8 8 169 170 171 139 140 141 8 8 110 110 415 416 463 464 465 466
423 424 8 379 8 8 112 8 9 11 11 11 43 44 44 44 44 44 44 44 44 44 44 44 44 44 45 115 117 11 7 8 382 8 8 8 8 8 1027 961 962 963 964 965 893 8 8 110 169 170 171 145 146 147 8 8 8 8 421 422 469 470 471 472
429 430 8 8 8 200 200 8 9 11 11 11 49 52 44 44 44 44 44 44 44 44 44 44 44 44 45 127 129 11 7 8 8 8 8 8 8 8 1033 985 986 987 988 989 899 8 110 110 169 170 171 151 152 153 200 8 8 8 427 428 475 476 477 478
411 412 200 200 200 200 200 8 9 11 11 11 11 43 44 44 44 44 44 44 44 47 44 44 44 44 45 11 11 11 7 8 8 110 110 8 8 8 1039 991 992 993 994 995 996 8 8 8 169 170 168 165 110 8 200 8 200 8 409 410 457 458 459 460
417 418 200 200 200 200 200 8 9 11 11 11 11 43 44 44 44 44 44 44 44 44 44 44 44 44 45 11 11 11 7 8 8 110 8 8 8 8 1045 997 998 999 1000 1001 1002 8 8 8 169 146 170 168 165 8 200 200 200 110 415 416 463 464 465 466
423 424 200 200 200 8 8 8 9 11 11 11 11 49 50 50 52 44 44 44 44 44 44 44 54 50 51 11 11 11 7 112 8 8 8 8 8 8 8 8 8 8 8 8 8 8 8 8 175 178 146 170 168 165 200 200 200 200 421 422 469 470 471 472
429 430 200 200 200 200 8 8 16 3 11 11 11 11 11 11 43 44 44 44 44 44 54 50 51 11 11 11 11 11 7 8 8 8 8 8 8 8 8 8 8 8 8 8 8 8 370 8 8 175 178 146 170 171 200 200 200 8 427 428 475 476 477 478
411 412 200 200 200 200 200 8 8 9 11 11 11 11 11 11 49 50 50 50 50 50 51 11 109 11 11 11 11 11 7 8 8 8 8 8 8 8 8 8 8 8 8 8 8 8 376 8 8 8 175 178 146 171 8 200 200 8 409 410 457 458 459 460
417 418 200 200 200 200 200 8 8 9 11 11 115 116 117 11 11 11 11 11 11 115 116 117 11 11 11 11 1 17 18 8 8 8 8 8 8 8 409 410 411 412 8 8 8 8 382 8 8 8 8 169 146 171 8 8 200 200 415 416 463 464 465 466
423 424 200 200 200 110 110 8 8 16 2 3 127 130 122 117 11 11 115 116 116 118 122 120 117 11 11 11 7 8 8 163 164 165 8 8 409 410 385 386 387 388 411 412 8 8 8 8 8 8 8 169 146 171 8 8 8 8 421 422 469 470 471 472
429 430 200 200 8 8 8 8 8 8 110 10 11 127 128 129 11 11 127 128 128 128 128 128 129 11 1 17 18 253 8 169 170 171 8 8 415 416 391 392 393 394 417 418 8 163 164 165 8 163 164 166 146 171 8 110 8 8 427 428 475 476 477 478
411 200 8 8 8 8 8 8 271 272 8 10 11 11 11 11 11 11 11 11 11 11 11 11 11 1 18 260 261 8 8 175 176 177 8 8 421 422 397 398 399 400 423 424 8 169 170 171 163 166 146 146 170 171 8 8 8 260 261 8 481 482 483 484
417 418 8 409 410 411 8 8 277 278 8 16 2 2 2 2 2 2 2 2 2 2 2 2 2 18 8 266 267 8 8 8 139 140 141 8 427 428 403 404 405 406 429 430 8 175 176 177 175 176 176 178 170 171 8 8 8 266 267 410 411 428 429 112
423 424 410 385 386 387 388 411 412 8 8 8 241 242 8 8 8 110 110 8 200 8 8 139 140 140 141 8 8 8 139 140 142 146 147 163 141 8 427 428 429 430 256 8 163 165 8 8 110 8 8 169 170 171 8 8 409 410 385 386 387 388 411 412
429 415 416 391 392 393 394 417 418 8 8 8 247 248 110 200 200 8 200 200 8 8 8 145 146 156 158 164 164 165 145 146 156 152 153 175 177 8 8 8 8 8 8 8 175 177 8 110 110 8 8 169 170 171 8 8 415 416 391 392 393 394 417 418
8 421 422 397 398 399 400 423 424 8 8 8 200 200 200 200 200 200 200 8 8 8 8 151 152 153 175 176 176 177 151 152 153 8 409 410 411 412 8 8 8 8 8 8 8 8 8 8 8 8 8 169 170 171 8 8 421 422 397 398 399 400 423 424
8 254 428 403 404 405 406 429 430 8 8 200 200 200 200 200 200 8 8 8 193 194 194 195 8 8 8 8 8 8 8 8 409 410 385 386 387 388 411 412 8 8 8 8 409 410 411 412 8 8 8 169 170 171 8 8 427 428 403 404 405 406 429 430
411 412 8 427 428 429 430 8 8 200 200 200 200 200 200 200 194 195 8 8 199 200 200 201 8 193 194 194 194 195 8 8 415 416 391 392 393 394 417 418 8 8 409 410 385 386 387 388 411 412 8 169 170 171 8 8 110 110 8 428 429 112 8 8
417 418 8 8 8 8 8 8 8 200 200 200 200 200 200 200 200 201 8 8 199 200 200 201 8 199 200 200 200 201 8 8 421 422 397 398 399 400 423 424 8 8 415 416 391 392 393 394 417 418 8 169 146 171 8 8 8 8 8 8 8 410 411 8
423 424 8 110 110 8 8 8 8 200 200 200 200 200 200 206 206 207 8 8 205 200 200 200 194 200 200 200 200 201 8 8 427 428 403 404 405 406 429 430 8 8 421 422 397 398 399 400 423 424 8 169 146 168 165 8 8 239 409 410 385 386 387 388
429 430 8 8 110 110 8 8 8 200 200 200 200 200 200 200 200 8 8 8 8 199 200 200 200 200 200 200 200 200 194 195 8 8 427 428 429 430 8 260 261 8 427 428 403 404 405 406 429 430 8 175 178 146 168 165 8 8 415 416 391 392 393 394
411 412 8 8 110 8 8 8 8 8 200 200 200 200 200 200 8 8 8 8 8 205 206 206 200 200 200 200 200 200 200 201 8 8 8 8 8 8 8 266 267 8 8 110 427 428 429 430 8 8 8 8 175 178 146 168 165 8 421 422 397 398 399 400
417 418 8 260 261 8 8 8 112 8 200 200 200 200 200 8 8 8 368 369 8 8 8 8 199 200 200 200 200 200 200 207 8 8 112 112 8 8 8 8 8 8 8 8 8 110 110 8 8 8 8 8 8 175 178 170 171 8 427 428 403 404 405 406
423 424 8 266 267 8 8 8 8 8 200 200 8 8 8 8 8 8 374 375 8 8 8 8 199 200 200 200 200 200 201 8 8 8 110 110 8 8 8 8 8 8 8 8 8 8 8 271 272 8 110 8 8 8 169 146 171 8 8 8 8 428 429 8
429 410 411 412 409 410 411 412 8 8 8 8 8 8 8 8 8 8 380 381 8 8 8 8 205 206 206 200 200 200 201 8 110 8 8 409 410 411 412 409 410 411 412 409 410 411 412 277 278 8 8 8 8 8 169 146 171 8 8 8 8 410 411 8
385 386 387 388 385 386 387 388 411 412 271 272 8 8 367 8 8 8 8 8 8 8 8 8 8 8 8 199 200 200 201 8 8 409 410 385 386 387 388 385 386 387 388 385 386 387 388 411 412 8 8 8 8 8 169 146 171 8 409 410 385 386 387 388
391 392 393 394 391 392 393 394 417 418 277 278 8 8 373 8 8 8 8 8 8 8 8 8 8 8 8 199 200 200 201 8 8 415 416 391 392 393 394 391 392 393 394 391 392 393 394 417 418 241 242 8 8 8 169 146 171 8 415 416 391 392 393 394
397 398 399 400 397 398 399 400 423 424 8 8 8 8 379 8 8 8 8 8 8 110 110 8 8 8 8 205 206 206 207 8 8 421 422 397 398 399 400 397 398 399 400 397 398 399 400 423 424 247 248 8 8 8 169 146 171 8 421 422 397 398 399 400
403 404 405 406 403 404 405 406 429 430 8 8 8 8 8 8 8 8 8 8 8 8 110 110 8 8 8 8 8 8 8 8 8 427 428 403 404 405 406 403 404 405 406 403 404 405 406 429 430 8 8 8 8 8 169 146 171 8 427 428 403 404 405 406
427 428 429 430 427 428 429 430 8 256 8 8 8 8 8 8 8 8 8 8 8 8 8 8 8 8 8 8 8 8 8 8 8 8 8 427 428 429 430 427 428 429 430 427 428 429 430 8 8 8 8 8 8 8 169 146 171 8 8 8 8 428 429 8
409 410 411 412 409 410 411 412 409 410 411 412 409 410 411 412 409 410 411 412 409 410 411 412 409 410 411 412 409 410 411 412 409 410 411 412 409 410 411 412 409 410 411 412 409 410 411 412 8 410 411 412 8 8 169 170 171 8 8 8 8 8 8 410